1111111111111111111111111111111111
100000000000000C00100C000000000001
1010010100100000101001000000010101
1010010010101010000001000000010101
100000000C00C00000E0P0000000000IC1
1111111111111111111111111111111111
