11111111111111111111111111111111111111111111111111111111111111
1000000000C0000000000000000000000000000000000000000000000000C1
100010000000111111100000C000000000000000C000011100000000000001
10001000000000000010000000000000000000000000011100000000000001
100010001000000C0010000000000000000000000000000000000000000001
10001111100011111110000000111101111101000011111011000101111101
1000000010001000000000C00010E001000101000010001010100101000001
10000000100C10000000000000111101000101000010001010010101011101
100000001000100000000000000001010001010C001000101000110100C101
100000P0100011111100000000111101111101111011111010000101111101
10000000000000000000000000000000000000000000000000000000000001
11111111111111111111111111111111111111111111111111111111111111
